NO textures/north.png
SO textures/south.png
WE textures/west.png
EA textures/east.png

C 255, 26, 35

F 207, 16, 32

        1111111111111111111111111
        1000000000110000000000001
        1011000001110000000000001
        1001000000000000000000001
111111111011000001110000000000001
1X0D0000001100000111D1111D1111111
11110111111111011100000010001
11110111111111011101010010001
1000000110101011100000010E001
10000000000000001100000010001
10000000000000001101010010001
1100000111010101111101111000111
11110111 1110101 101111010001
11111111 1111111 111111111111