NO textures/north.png
SO textures/south.png
WE textures/west.png
EA textures/east.png

C 135, 206, 235

F 207, 16, 32


111111111111111111
10000000E010000001
10000000000X000001
1000000000D0000001
1000000000D00000011111
1000000000D000001
10000000001000011
11111111111111111