NO textures/north.png
		  SO textures/south.png
  WE textures/west.png


	EA textures/east.png



F  220,100,0

C  225,30,0



11111111111111111
10000000000000001
100000000E0000001
11111111111111111