NO textures/north.png
		  SO textures/south.png
  WE textures/west.png


	EA textures/east.png



F  0xFF000000

C  0xFF000000



11111111111111111
10000000000000001
100000000E0000001
11111111111111111