NO textures/north.png
SO textures/south.png
WE textures/west.png
EA textures/east.png

C 0, 0, 0

F 0, 0, 50

                        111111
                        100001
      11        11111   100001
   11111     11100001    1111                                                      
 1110001     10000001      1                                                       
11000001     10000001      1     111              1111111                          
 1000001     10000001     111   100111           110000001      111111111          
 1000001     10000001   110001  100001           100000001   111000000000111       
 1000001     10000001   100001  1100001          100000001  10000000000000011    
 1000001     10000001   100001   1000011         100000001  1000000000000000011    
 1100001     10000001   100001    100001         100000011 100000001111110000011   
  100001 111110000001  1100001    100001        110000011  100000001    10000001   
  100001110000000000111100000111110000011       10000001   100000001    100000011  
  100W000000000000000000000000000000000011      10000011    1000000011110000X0001  
  10000000000000000000000000000011100000011     100000011   100000000000000000011
  100000000000000000001100000011  1100000011   110000000011110000000000000000111   
  11000001111111110001 10000001     100000011  1000000000000000000001111111111     
   1000001       10001 10000001     110000001 11000000000000000000001          11  
   1000001      110001 10000001      1000000111000001110000000000000111   11111101 
   1000001      100001 10000001       11000001100001  11100000000000001111100000011
   11000011    1100001 100000001       1000001000011    110000000000000000000000001
    1000001    1000001 100000001        10000000001       1100000000000000000000011
    1000001   11000001 100000001        1100000001         11000000000000000000011 
    1001111   10000011 10000001          100000011           11100000000000001111  
    1111      1000001  11100111           1111111               1111111111111      
              1110001    111                                                       
                 1111                                                                                      